44 46 47 46 47 46 46 47 47 46 47 46 47 46 46 46 47 47 46 46 47 46 47 47 46 46 46 47 46 46 47 46 47 46 46 47 47 47 46 45
35 00 06 01 04 00 04 03 02 00 05 06 03 00 01 04 03 02 00 06 01 03 04 05 00 02 03 04 06 02 00 01 03 01 04 05 00 02 06 39
36 02 00 06 01 03 04 05 00 02 03 04 06 02 00 01 04 02 00 06 05 01 04 03 00 02 06 00 03 05 01 04 04 01 05 03 04 06 02 39
36 04 06 03 01 04 05 00 02 06 03 00 04 01 05 03 04 06 02 00 05 03 01 04 00 06 02 03 05 00 01 03 05 03 01 04 00 06 05 40 
35 06 02 00 05 03 01 04 00 06 05 01 02 00 04 03 05 04 06 03 01 04 05 00 02 06 03 00 04 01 05 03 00 06 05 01 02 00 04 40 
37 02 00 06 05 01 04 03 00 02 06 00 03 05 01 04 03 00 02 06 03 04 05 00 01 03 04 06 02 00 05 03 03 04 06 00 02 03 03 39
36 00 02 06 03 04 05 00 01 03 04 06 02 00 05 03 05 00 06 01 04 00 04 44 46 45 05 06 03 00 01 04 48 48 01 04 03 00 02 39
37 03 04 06 00 02 03 03 04 01 02 05 00 02 04 01 05 00 01 04 03 02 06 37 05 40 00 04 03 06 02 03 48 48 06 03 01 04 05 40
35 01 05 02 00 04 03 01 06 02 05 44 46 46 47 46 47 46 46 47 47 46 47 37 02 39 05 04 48 02 48 48 00 03 48 48 03 02 00 39
37 02 05 01 03 00 04 06 02 01 05 36 03 04 02 01 00 06 05 00 01 02 01 03 04 40 04 00 48 01 48 48 05 02 48 48 04 06 01 39
36 00 01 04 03 02 06 00 05 01 00 36 03 06 02 03 28 12 11 30 03 01 03 03 04 39 02 05 06 02 04 01 02 04 01 05 00 05 06 40
36 00 06 01 04 00 04 03 02 00 05 49 50 23 22 41 03 11 10 06 38 42 23 23 42 32 04 06 02 00 01 03 01 04 05 00 02 48 03 39
37 02 00 06 01 03 04 05 00 02 03 51 52 24 25 36 04 10 12 05 39 43 25 24 43 34 00 03 05 01 04 04 48 05 03 04 06 48 00 40
35 04 06 03 01 04 05 00 02 06 03 53 54 01 05 35 04 08 29 05 39 48 04 00 06 02 03 05 48 48 48 05 48 01 04 00 06 05 01 39
36 06 02 00 05 03 01 04 00 06 05 30 29 00 04 31 22 42 23 22 32 48 05 00 02 06 03 00 48 48 48 03 05 06 48 01 02 00 04 40 
37 02 00 06 05 01 04 03 00 02 06 28 08 05 01 33 24 43 25 24 34 04 05 00 01 03 04 06 48 48 48 03 48 04 02 00 48 03 03 39
35 00 02 06 03 04 05 00 01 03 04 29 09 00 48 57 05 48 06 01 04 00 04 48 02 00 05 06 03 00 01 04 06 05 01 04 03 00 02 40
36 03 04 06 00 02 03 03 04 01 02 09 08 30 57 48 05 48 07 10 08 12 30 48 05 01 00 04 03 06 02 03 05 04 06 03 01 04 05 39
37 01 05 02 00 04 03 01 06 02 05 09 10 09 10 09 12 09 12 13 14 15 08 10 08 09 10 12 08 30 28 02 07 05 04 03 02 01 00 40
35 02 05 01 03 00 04 06 02 01 03 03 29 09 09 12 09 28 08 16 17 18 09 12 09 10 08 09 29 08 30 29 05 04 03 02 01 03 01 39
36 00 01 04 03 02 06 00 05 01 00 04 03 06 10 12 29 03 12 19 20 21 10 03 04 01 02 05 00 02 04 01 02 04 01 05 00 05 06 39
36 00 06 01 04 00 04 03 02 00 05 06 03 00 12 09 03 02 28 12 09 10 29 05 00 02 03 04 06 02 00 01 03 01 04 05 00 02 06 40
37 02 00 06 01 03 04 05 00 02 03 04 06 02 08 10 04 02 00 06 05 01 04 03 00 02 06 00 03 05 01 04 04 01 05 03 04 06 02 39
35 04 06 03 01 04 05 00 02 06 03 00 04 01 10 09 04 06 02 00 05 03 01 04 00 06 02 03 05 00 01 03 05 03 01 04 00 06 05 40 
36 06 02 00 05 03 01 04 00 06 05 01 02 00 12 09 05 04 06 03 01 04 05 00 02 06 03 00 04 01 05 03 00 06 05 01 02 00 04 39 
36 02 00 06 05 01 04 03 00 02 06 00 03 05 09 08 03 00 02 06 03 04 05 00 01 03 04 06 02 00 05 03 03 04 06 00 02 03 03 39
35 00 02 06 03 04 05 00 01 03 04 06 02 00 10 12 05 00 06 01 04 00 04 03 02 00 05 06 03 00 01 04 06 05 01 04 03 00 02 40
36 03 04 06 00 02 03 03 04 01 02 05 00 02 09 10 05 00 01 04 03 02 06 00 05 01 00 04 03 06 02 03 05 04 06 03 01 04 05 40
37 01 05 02 00 04 03 01 06 02 05 01 03 07 55 56 30 01 05 00 04 03 02 06 01 00 05 04 03 02 01 06 00 05 04 03 02 01 00 39
36 02 05 01 03 00 04 06 02 01 05 00 04 08 56 55 10 00 05 00 04 03 02 01 06 00 05 04 03 02 01 06 00 05 04 03 02 01 03 40
35 02 00 06 01 03 04 05 00 02 03 04 06 10 55 55 09 02 00 06 05 01 04 03 00 02 06 00 03 05 01 04 04 01 05 03 04 06 02 39
36 04 06 03 01 04 05 00 02 06 03 00 04 28 48 48 08 06 02 00 05 03 01 04 00 06 02 03 05 00 01 03 05 03 01 04 00 06 05 39
37 06 02 00 05 03 01 04 00 06 05 01 02 09 29 08 12 04 06 03 01 04 05 00 02 06 03 00 04 01 05 03 00 06 05 01 02 00 04 40 
36 02 00 06 05 01 04 03 00 02 06 00 03 08 28 30 07 00 02 06 03 04 05 00 01 03 04 06 02 00 05 03 03 04 06 00 02 03 03 39
37 00 02 06 03 04 05 00 01 03 04 06 02 07 08 28 29 00 06 01 04 00 04 03 02 00 05 06 03 00 06 04 06 05 01 04 03 00 02 40
37 03 04 06 00 02 03 03 04 01 02 05 00 02 04 01 05 00 01 04 03 02 06 00 05 01 00 04 03 06 02 03 05 04 06 03 01 04 05 39
35 01 05 02 00 04 03 01 06 02 05 01 03 00 04 06 02 01 05 00 04 03 02 06 01 00 05 04 03 02 01 06 00 05 04 03 02 01 00 40
36 02 05 01 03 00 04 06 02 01 05 00 04 03 02 06 01 00 05 04 03 02 01 06 00 05 04 03 02 01 06 00 05 04 03 02 01 03 01 40
31 22 22 22 22 22 22 22 22 22 22 22 22 22 22 22 22 22 22 22 22 22 22 22 22 22 22 22 22 22 22 22 22 22 22 22 22 22 22 32
33 24 24 24 24 24 24 24 24 24 24 24 24 24 24 24 24 24 24 24 24 24 24 24 24 24 24 24 24 24 24 24 24 24 24 24 24 24 24 34
